04,04,02,03,04,05,06,07,09,49,95,95,95,77,77,95,95,95,95,95,95,95,95,95,95,95,95,95,95,95,95,95,95,95,95,95
10,11,04,04,04,04,16,17,18,19,95,77,77,77,77,95,95,95,95,95,95,95,95,95,95,95,95,95,95,95,95,95,95,95,95,95
20,21,22,23,24,25,04,04,04,95,95,77,75,76,77,95,95,95,95,95,95,95,95,95,95,95,95,95,95,95,95,95,90,90,90,90
30,31,32,33,34,35,36,37,38,95,95,95,95,95,95,95,95,95,95,95,95,95,95,95,95,95,95,95,95,95,95,90,90,90,90,90
40,41,42,43,44,45,46,47,08,95,95,95,95,95,95,95,95,95,95,95,95,95,95,95,95,95,95,95,95,95,90,90,90,90,90,90
50,51,52,53,54,55,56,57,58,59,95,95,95,95,95,95,95,90,90,90,90,90,90,90,90,90,90,90,90,90,90,90,90,90,90,90
60,61,62,63,64,65,66,67,68,69,90,95,95,95,95,95,95,95,90,90,90,90,90,90,90,90,90,90,90,90,90,90,90,90,90,90
70,71,72,73,74,75,76,77,78,79,90,90,90,90,90,90,95,95,95,95,95,95,95,95,90,90,90,90,90,90,90,90,90,90,90,90
80,81,82,83,84,85,86,87,88,90,90,90,90,90,90,90,90,90,90,90,90,90,90,90,90,90,90,90,90,90,90,90,90,90,90,90
90,91,92,93,94,95,90,90,90,90,90,90,90,90,90,90,90,90,90,90,90,90,90,90,90,90,90,90,90,90,90,90,90,90,90,90
90,90,90,90,90,90,90,90,90,90,90,90,90,90,90,90,90,90,90,90,90,90,90,90,90,90,90,90,90,90,90,90,90,90,90,90
90,90,90,90,90,90,90,90,90,90,90,90,90,90,90,90,90,90,90,90,90,90,90,90,90,90,90,90,90,90,90,90,90,90,90,90
90,90,90,90,90,90,90,90,90,90,90,90,90,90,90,90,90,90,90,90,90,90,90,90,90,90,90,90,90,90,90,90,90,90,90,90
90,90,90,90,90,90,90,90,90,90,90,90,90,90,90,90,90,90,90,90,90,90,90,90,90,90,90,90,90,90,90,90,90,90,90,90
90,90,90,90,90,90,90,90,90,90,90,90,90,90,90,90,90,90,90,90,90,90,90,90,90,90,90,90,90,90,90,90,90,90,90,90
90,90,90,90,90,90,90,90,90,90,24,07,07,07,07,07,07,07,07,07,07,07,07,07,07,07,07,07,07,07,07,07,07,07,07,07
90,90,90,90,90,90,90,90,90,24,34,65,65,65,65,65,65,65,65,65,65,65,65,65,65,65,65,65,65,65,65,65,07,07,07,07
90,90,90,90,90,90,90,90,24,34,65,65,65,65,65,65,65,65,65,65,65,65,36,36,36,36,36,36,36,36,36,65,36,36,65,65
08,00,00,00,00,00,00,00,65,65,65,65,65,65,65,65,65,65,65,65,65,65,65,65,65,65,65,65,65,65,36,36,36,36,65,65
03,03,03,03,03,03,03,00,00,00,00,00,00,00,00,00,00,00,00,00,00,00,00,00,00,00,00,00,00,00,00,00,00,00,00,09
03,03,03,03,03,03,03,03,03,03,03,03,03,03,03,03,03,03,03,03,03,03,03,03,03,03,03,03,03,03,03,03,03,03,03,03
03,03,03,03,03,03,03,03,03,03,03,03,03,03,03,03,03,03,03,03,03,03,03,03,03,03,03,03,03,03,03,03,03,03,03,03
03,03,03,03,03,03,03,03,03,03,03,03,03,03,03,03,03,03,03,03,03,03,03,03,03,03,03,03,03,03,03,03,03,03,03,03
03,03,03,03,03,03,03,03,03,03,03,03,03,03,03,03,03,03,03,03,03,03,03,03,03,03,03,03,03,03,03,03,03,03,03,03

